TTTTTTTTTTTTTT
T        R TTT
T     R  R TTT
T          TTT
T  T           
T      R   TTT
T   R    R TTT
T        R TTT
TTTTTTTTTTTTTT