TTTTTTTTTTTT
T        R T
T     R  R T
T   T      T
T           
T      R   T
T   R    R T
T        R T
TTTTTTTTTTTTTTTT